# Gboard Dictionary version:1
えーりん	(　ﾟ∀ﾟ)o彡゜えーりん！えーりん！	ja-JP
てい	てゐ	ja-JP
おおかみれい	オオカミ霊	ja-JP
おおわしれい	オオワシ霊	ja-JP
かわうそれい	カワウソ霊	ja-JP
ていれいだ	丁礼田	ja-JP
ていれいだまい	丁礼田舞	ja-JP
くたか	久侘歌	ja-JP
つくもやつはし	九十九八橋	ja-JP
つくもべんべん	九十九弁々	ja-JP
にんげんれい	人間霊	ja-JP
よりがみじょおん	依神女苑	ja-JP
あいどる	偶像	ja-JP
うどんげいん	優曇華院	ja-JP
やちえ	八千慧	ja-JP
ごうよく	剛欲	ja-JP
ごうよくいぶん	剛欲異聞	ja-JP
けいがぐみ	勁牙組	ja-JP
ちまた	千亦	ja-JP
はくれいれいむ	博麗霊夢	ja-JP
きっちょう	吉弔	ja-JP
きっちょうやちえ	吉弔八千慧	ja-JP
しきえいき	四季映姫	ja-JP
はにやすしんけいき	埴安神袿姫	ja-JP
てんきゅう	天弓	ja-JP
てんきゅうちまた	天弓千亦	ja-JP
おくのだみよい	奥野田美宵	ja-JP
ようき	妖忌	ja-JP
ひめむしももよ	姫虫百々世	ja-JP
にゃんにゃん	娘々	ja-JP
みやでぐちみずち	宮出口瑞霊	ja-JP
ゆうま	尤魔	ja-JP
やましろたかね	山城たかね	ja-JP
にわたり	庭渡	ja-JP
にわたりくたか	庭渡久侘歌	ja-JP
べんべん	弁々	ja-JP
しんきろう	心綺楼	ja-JP
えびす	戎	ja-JP
えびすえいか	戎瓔花	ja-JP
またら	摩多羅	ja-JP
さき	早鬼	ja-JP
ちれいきでん	智霊奇伝	ja-JP
もとおり	本居	ja-JP
もとおりこすず	本居小鈴	ja-JP
じょうとうぐう	杖刀偶	ja-JP
じょうとうぐうまゆみ	杖刀偶磨弓	ja-JP
とうほうごうよくいぶん	東方剛欲異聞	ja-JP
とうほうしんきろう	東方心綺楼	ja-JP
とうほうちれいきでん	東方智霊奇伝	ja-JP
とうほうじゅうおうえん	東方獣王園	ja-JP
とうほうすいちょうか	東方酔蝶華	ja-JP
ちぇん	橙	ja-JP
ひょうせい	氷精	ja-JP
えいえんとしゅゆのざいにん	永遠と須臾の罪人	ja-JP
せいらん	清蘭	ja-JP
にしだ	爾子田	ja-JP
にしださとの	爾子田里乃	ja-JP
じゅうおうえん	獣王園	ja-JP
たまつくりみすまる	玉造魅須丸	ja-JP
えいか	瓔花	ja-JP
ちくしょうかい	畜生界	ja-JP
ももよ	百々世	ja-JP
やたでらなるみ	矢田寺成美	ja-JP
まゆみ	磨弓	ja-JP
はたのこころ	秦こころ	ja-JP
きしん	稀神	ja-JP
じゅんこ	純狐	ja-JP
わたつきのとよひめ	綿月豊姫	ja-JP
そうりょうむすめ	総領娘	ja-JP
まい	舞	ja-JP
いぎりすぎゅう	英吉利牛	ja-JP
くだまきつかさ	菅牧典	ja-JP
ほあれんしゃおにゃん	華人小娘	ja-JP
こうりゅうどう	虹龍洞	ja-JP
むし	蟲	ja-JP
けいき	袿姫	ja-JP
とよさとみみのみこ	豊聡耳神子	ja-JP
かぐや	輝夜	ja-JP
いどらでうす	造形神	ja-JP
すいちょうか	酔蝶華	ja-JP
さとの	里乃	ja-JP
れいせん	鈴仙	ja-JP
れいせんうどんげいんいなば	鈴仙・優曇華院・イナバ	ja-JP
おきな	隠岐奈	ja-JP
れいうじうつほ	霊烏路空	ja-JP
れいちょうえん	霊長園	ja-JP
せいが	青娥	ja-JP
せいがにゃんにゃん	青娥娘々	ja-JP
せいしょう	青霄	ja-JP
いいずなまるめぐむ	飯綱丸龍	ja-JP
とうてつ	饕餮	ja-JP
とうてつゆうま	饕餮尤魔	ja-JP
こまくささんにょ	駒草山如	ja-JP
くろこま	驪駒	ja-JP
くろこまさき	驪駒早鬼	ja-JP
きけつぐみ	鬼傑組	ja-JP
きけいじゅう	鬼形獣	ja-JP
こんぱくようき	魂魄妖忌	ja-JP
みすまる	魅須丸	ja-JP
めぐむ	龍	ja-JP
